*-*-*-*-*-*-*-*-*-*-*
|     |             |
* *-* * *-*-*-* * * *
|   |     |     | | |
*-*-*-* * * * *-* *-*
|     | | | |   |   |
* *-* *-* * *-*-*-* *
|   |     | |   | | |
* * *-*-*-*-* * * * *
| | |         | |   |
* * * *-*-*-*-* * *-*
| | |         | |   |
*-* *-*-*-*-*-* * * *
|   |   |       | | |
* * * * * *-* *-*-* *
| | | | |   | |   | |
* *-* * *-* *-* * * *
| |   |   |   | |   |
* * * *-* *-* * *-*-*
|   |   |     |     |
*-*-*-*-*-*-*-*-*-*-*
