*-*-*-*-*-*-*-*-*-*-*-*-*-*-*-*-*-*-*-*-*
|     |   |               |         |   |
* * * * * *-* * *-* *-* * *-* * * * * * *
| | |   |   | | |   | | |   | | | |   | |
* *-*-* *-* * * *-*-* * *-* *-* *-* * * *
|   | | |   | | |   | |   |   |   | | | |
*-* * * * *-* * * * * *-* * * *-* *-* * *
|   |   |     | | | |     | |     |   | |
* *-*-*-*-*-*-* * * * * *-* *-*-*-* *-* *
|             |   | | |   |   |   |   | |
* *-*-*-*-*-* *-*-* * *-* * * * * *-* * *
|     |     |   |   | |   | |   | | | | |
* *-* *-* * *-* *-*-* *-*-*-*-* * * * *-*
|   |   | |     |   | |       | |   |   |
* * *-* *-*-*-* * * * * *-*-* *-*-*-*-* *
| | | |       | | | | |     |           |
* * * * * *-* *-* * *-*-*-* * *-* * *-* *
| |   | |   | |   |     | | |   | |   | |
* * *-* *-*-* * *-*-*-* * * * * * *-* * *
| |   |     |   | |     |   | | | |   | |
* *-* * *-* *-*-* * *-*-*-* *-* * *-*-*-*
| | | |   |       |       | |   | |     |
* * * *-*-*-*-*-*-* * *-* * * *-*-* *-* *
| |   |             |   | | | |     |   |
* * *-* *-*-*-*-*-*-*-*-* * * * *-*-* *-*
| | |   |     |           | |   |   |   |
* *-* *-* * * * *-*-*-*-* * *-*-*-* *-* *
|   |     | | | |   |   | |         |   |
*-* *-*-*-* * * *-* * * *-* *-*-*-*-* * *
|   | |   | | |   |   |   | |       | | |
* *-* * *-* * *-* *-*-* * *-* *-*-* * * *
|   | |     | | |     | |     |     | | |
*-* * *-*-*-* * *-*-* *-*-*-*-* *-*-* * *
| | |         |       |       |       | |
* * * *-*-*-*-* *-*-* * *-*-* *-*-*-* * *
|   | |       |     | |   | |       | | |
* *-* * *-*-* *-*-* *-*-* * *-*-*-* * * *
| | | | |     |   | |     | |       | | |
* * * *-* * *-* *-* * *-*-* * *-*-*-*-* *
|   |     |   |     |       |           |
*-*-*-*-*-*-*-*-*-*-*-*-*-*-*-*-*-*-*-*-*
