*-*-*-*-*-*
| |     | |
* * * * * *
| | | |   |
* *-* *-* *
|     |   |
* *-*-* *-*
| |   | | |
* *-* * * *
|     |   |
*-*-*-*-*-*
