*-*-*-*-*-*-*-*-*-*-*-*-*-*-*-*-*-*-*-*-*
|                   | |   |   |   |   | |
*-*-*-* *-*-*-* *-* * *-* * *-* *-*-* * *
|   |   |     |   | | |   |         |   |
*-* *-*-*-*-* * *-*-* * *-* * *-*-*-* *-*
|   | | | | | | | |         |   | |     |
*-* * * * * * * * * *-* * *-*-*-* *-* * *
| |   | |   | |       | |   | | | |   | |
* * *-* *-* * * * *-*-*-* *-* * * * *-*-*
|             | | | | | | | | |   | | | |
*-*-* *-* *-* * *-* * * * * * *-* * * * *
|   | | | |   | |   | | | | |       | | |
* *-*-* *-*-* * *-* * * *-* * * * *-* * *
|     |           |   | |   | | | |   | |
*-* *-*-*-*-* * *-*-* * * *-*-*-* * *-* *
| |   |       |     | | | | |       |   |
* * *-*-*-*-*-*-* *-* * * * *-* *-*-* * *
|   | |     |     | |   | | | |       | |
* *-* *-*-* *-*-* * * *-* * * * *-*-*-*-*
| |   |   |   | | |   | |               |
* * *-* *-*-* * * * *-* *-* * * *-* * *-*
| | |   |   | |     |       | | |   | | |
* * *-* *-* * * *-* * *-*-*-* *-*-* * * *
| | | |   | | | |       |   | | |   | | |
* * * * *-* * *-* *-*-*-*-* *-* *-* *-* *
|     | | |               |   |   | |   |
* *-* * * *-*-* *-* * *-* * *-*-* *-*-* *
| |             |   | | | | | | |   | | |
*-*-* *-*-*-*-* *-* *-* *-* * * * *-* * *
|         |   | | | |   | | |     |   | |
*-* * *-*-*-* *-* * * *-* * * * *-*-* * *
|   | | |           | |       | |   | | |
*-* *-* * * *-*-*-* * *-*-* *-*-* *-* * *
|   | |   | |   |       |   |           |
*-*-* *-*-*-*-* *-* * *-*-* *-* *-* *-* *
| |     |   |   | | |   |       |   | | |
* *-*-* * * *-* * *-* *-* *-* *-*-* * *-*
|   |   | |   | |     |     |     |     |
*-* *-* *-*-* * * * *-*-* *-*-*-* * *-*-*
|   |     |       |   |         | |     |
* *-*-*-* *-* * *-* * * *-*-* *-*-* *-*-*
|   | |     | | | | |   | | | | |   |   |
*-* * *-*-* *-*-* * *-* * * *-* *-*-*-* *
|                     |             |   |
* *-*-*-*-* * *-* * *-*-*-* *-* * * * *-*
| |         | |   |       | |   | |   | |
* * *-* *-* * * *-* * * *-* *-* *-* *-* *
| |   | |   | | |   | |   |   | |       |
*-*-* * *-* *-*-*-* * *-* *-* *-*-* *-* *
| |   | |     |   | | |   |       | | | |
* *-*-*-* *-* *-* * *-*-* *-* *-* *-* *-*
| |         | |       | |   |   |       |
* *-*-*-* *-* * *-*-* * * *-* * *-*-*-* *
|     | | | | |     |   | | | |       | |
* *-* * * * *-* *-*-* *-* * *-*-* *-*-*-*
| |           | |     |       |         |
*-*-* * *-* *-*-*-*-* *-* * * *-* *-*-*-*
|     | |       | |     | | | |         |
*-* * *-*-* *-*-* * *-*-* *-* *-*-* *-* *
|   | |           |     |   |   |     | |
*-*-*-*-*-*-*-*-*-*-*-*-*-*-*-*-*-*-*-*-*
