*-*-*-*-*-*-*-*-*-*-*-*-*-*-*-*
|         |   | | |   |   |   |
*-*-* *-*-*-* * * * *-* *-*-* *
|         |     | |   |   | | |
* *-*-* *-*-* *-* * *-*-* * * *
|   |     |             |   | |
*-*-*-* *-*-* *-*-* *-*-*-* * *
| |       |   |       |     | |
* *-*-* *-*-*-*-*-* *-*-*-* * *
|     |   | |     |       |   |
*-*-* *-* * *-* *-*-*-* *-*-* *
|     |     | | | | |   |   | |
* *-* *-*-* * * * * *-* *-* * *
| |   | |   | | | | |   | | | |
*-* * * * * * * * * *-* * * * *
| | |   | |   | | | | |   | | |
* *-*-* *-*-* * * * * * * * * *
| |   | | |             |     |
* *-* * * *-*-*-* * *-* *-* * *
| |       |   | | | |   |   | |
* *-*-* *-* *-* * *-* *-* *-* *
|     | | |   |   | | | | | | |
* * * * * * *-*-*-* *-* * * *-*
| | |   | | |       |         |
*-*-*-* * * *-*-* *-*-* *-*-*-*
| |     |                     |
* *-* * * *-* * * * * *-* *-*-*
|   | |   |   | | | | |       |
*-* *-* *-*-* * * * *-* *-* *-*
|         |   | | | |     |   |
*-*-*-*-*-*-*-*-*-*-*-*-*-*-*-*
