*-*-*-*-*-*-*-*-*-*-*-*-*-*-*-*
|   |     |       |   |       |
*-* * * *-* *-* * * * *-* *-* *
|   | |     | | |   |     |   |
* *-* *-*-*-* * *-*-*-*-*-* *-*
| |   |       | |         |   |
* * *-*-* *-* * *-*-*-*-* *-* *
| | |   | |   |         |   | |
* * * * * *-*-*-*-* *-* * *-* *
| |   |   |       | | | | |   |
* *-*-*-* * *-*-* * * * * * *-*
|     |   |     | |   | | |   |
* *-* * *-*-*-* * * *-* * *-* *
| | |   | |     | | |   |   | |
* * *-*-* * *-*-* * * *-* * * *
|     |   | |   | | | | | |   |
*-*-* * * * *-* * *-* * * *-*-*
|     | | |   | | |   | |   | |
* *-*-*-* *-* * * * *-* *-* * *
|           | |     |         |
*-*-*-*-*-*-*-*-*-*-*-*-*-*-*-*
