*-*-*-*-*-*-*-*-*-*-*
|   |     |   |     |
*-* * *-* * * * *-* *
|   | |   | |     | |
* *-* * * * *-*-*-* *
| |   | | | | |   | |
* * *-* *-* * * * * *
| | | |       | |   |
* * * *-*-*-*-* *-*-*
| | |   |       |   |
* * *-* * *-*-*-*-* *
|   | | | |         |
* *-* * * *-* *-*-* *
|   | | | |   |     |
*-* * * * * *-* *-*-*
|   | |   | | |   | |
* *-* *-*-* * *-* * *
| |   |     |   |   |
* * * * *-*-* * *-* *
|   |   |     |     |
*-*-*-*-*-*-*-*-*-*-*
