*-*-*-*-*
|   |   |
* * * *-*
| | |   |
* *-*-* *
|       |
*-*-*-* *
|       |
*-*-*-*-*
